R 1280 720

NO ./textures/brick.xpm
SO ./textures/blue.xpm
WE ./textures/wood.xpm
EA ./textures/grey.xpm
S ./textures/chalice.xpm

C 255,0,255
F 212,12,121


11111111111111111111
10000000000000110001
10000000000000110201
10000000000S00110001
10000002000000110001
10000000000000110001
11111100000000110001
     100000000110001111
11111100000000110000001
10000000000000110000201
10020000000000110000001
10000000000000000011111
11111111000000000000121
10000001000000000000001
10002001000000000000001
10000000000000000000001
10000000000000000000001
10000000000000000000001
10000111111000000000001
100001    1000000000011
100001    100000001111
111111    1111111111
